--47-----
--563-41-
--7--1--2
2--38-15-
-1--7-8--
--9-2----
--2--4-6-
3-8---9-5
9----3---
