---4----3
9----1---
651-9----
-2-1-36--
5-----9--
--4--5-3-
-7-5--8--
--6---2--
8---4---7
