4-1--52--
6-73--85-
-53-7--1-
-8-243---
-----9--1
--48----2
3----69--
----2-5-8
-7-9----6
