-----1---
-328---9-
58---26--
---193-6-
---------
-5-627---
--32---81
-1---647-
---3-----
