513------
---9--7--
-7--15---
6----72--
---461---
--45----8
---63--7-
--5--4---
------684
