49---3--2
7---6----
--2---53-
-69-4----
3-------1
----2-36-
-74---2--
----9---3
6--5---94
