----1463-
---2--7--
--6----91
-2---7---
4---6---7
---3---5-
23----1--
--1--3---
-5782----
