--5---9-1
---5-2---
--1--875-
3--18--2-
58--6--17
-7--25--9
-472--1--
---9-4---
9-3---2--
