-3---84-5
57--6-8--
-----56--
--5-8----
89-----42
----1-3--
--67-----
--3-5--64
7-23---5-
